############
#  .     . #
#   $   $  #
#    @     #
#          #
#        **#
############