#################
#              .#
#    *      $   #
# @           ###
#           ##
#         ##
#        #
#########
