############
#  .       #
#   $      #
#    @     #
#          #
#        **#
############