##############
## @##########
##    #  #####
## $##########
###   $ #  ###
#   ##########
##   ##   ####
## ..####   ##
##########   #
########    ##
######   #####
##############