##########################
#   .                .   #
#    $              $    #
#     @               ####
#    $              $   ##
#   .                .  ##
#          $        .  ###
##########################
