#########
#  .  @ #
#   $   #
#    ####
#########
#########
