######
#@  .#
# $  #
#    #
######
