############
#  .       #
#   $ ##*  #
#    @     #
#          #
#  *     * #
############
