############
#  .     . #
#   $   $  #
#    @     #
#   $   $  #
#  .     . #
############
