##############
## @##########
##    #  #####
## $##########
#            #
###     #  ###
#      #######
##   ##   ####
##  .####   ##
##########   #
########    ##
######   #####
##############