#################
#   .        .  #
#    $      $   #
# @           ###
#    $      $  ##
#   .        . ##
#               #
#################
