##################
#          .     #
# #  #######    ##
#                #
# ##### $ ###   ##
# ##    @  #######
##################